-,*,-,*,-,*,-,
A,N,I,M,A,L,N,
P,C,#,E,N,S,E,
#,H,#,P,#,O,#,
#,E,O,S,#,N,#,
C,A,K,E,Y,G,#,