-,*,-,*,-,*,-,
A,N,I,M,A,L,N,
P,C,#,E,N,S,E,
#,H,#,P,#,O,X,
#,E,O,L,#,N,#,
C,A,K,#,A,G,#,