-,*,*,*,-,
A,N,I,M,A,
P,C,#,E,L,
#,H,#,P,#,
#,E,O,S,#,
C,A,K,E,Y,
#,#,#,#,#,
#,#,#,#,#,
#,#,#,#,#,
#,#,#,#,#,
#,#,#,#,#,