-,*,-,*,-,*,-,
A,N,I,M,A,L,N,
P,C,P,E,N,S,E,
#,H,E,P,#,O,X,
#,E,O,L,#,N,G,
C,A,K,#,A,G,T,