-,*,*,*,-,
A,N,I,M,A,
P,C,#,E,N,
#,H,#,P,#,
#,E,O,S,#,
C,A,K,E,Y,
#,#,#,#,#,
#,#,#,#,#,
#,#,#,#,#,
#,#,#,#,#,
#,#,#,#,#,